NO textures/small-wall-1.xpm
SO textures/small-wall-2.xpm
WE textures/small-wall-3.xpm
EA textures/small-wall-4.xpm

F 50,50,50
C 135,206,235

11111111111111111111111111111111111111111
10000000000000000100000000000000000000001
10100000111111100100000111111111111000001
10100000100000100100000100000000001000001
10100000100000100100000100000000001000001
10100000100000100100000100111111111000001
10100000100000000100000100100000000000001
10100000111111111111111100111111100000001
10100000000000000000000100000000100000001
10111111111111111100000111111100100000001
10000000000000000100000000000100100000001
11111111111111100111111111100111100000001
10000000000000100000000000100000000000001
10000000000000100000000000111111111111111
10000000N00000100000000000000000000000001
10000000000000100000000000000000000000001
10000000000000100000000111111111111111101
10000000000000100000000100000000000000001
10000000000000100000000100000000000000001
11111111111111111111111111111111111111111