NO ./textures/small-wall-1.xpm
SO ./textures/small-wall-2.xpm
WE ./textures/small-wall-3.xpm
EA ./textures/small-wall-4.xpm

F 50,50,50
C 135,206,235

111111
100001
101D11
1100N1
111111

