NO ./textures/small-wall-1.xpm
SO ./textures/small-wall-2.xpm
WE ./textures/small-wall-3.xpm
EA ./textures/small-wall-4.xpm

F 50,50,50
C 135,206,235

111111
10000111111111111111111
101000000000000000001111111111111111111111111111111111111111111
1100N111111111111111111111111111111111
111111

